/--------\
|........|
|........|
|........|
|........|
|........|
|........|
|........|
|........|
\--------/