111111111111111111111111111111111111111111111
111111111111111111111111111111111111111111111
111111111111111111111111111111111111111111111
111001000000000000001111111111000000000000000
111001000000000000001111111100000000000000000
111000000000000000001111111000000000000000000
111000000000000000001111100000000000000000000
111000011100000000001111000000000000000000000
111000011100000000001111000000000000000000000
111000011100000000001111000000000000110000111
111000000000000000001111000000001111111100111
111000000000000000001110000000001111111111111
111000000000000000001110000000000011111111111
111000000000000000001110000000000001111111111
111000000000000000001110000000000000011111111
111111110000101111111110000000000000011111111
111111110000001111111110000000000000001111111
111111110000001111111110000000000000000111111
111000000000000000001110000110000000000011111
111000000000000000001110000011110000000000111
111000000000000000001110000011110000000000111
111000000000000110001110000001000000000000111
111000000000000110001110000000000000000000111
111000000000000000001110000000000000000000111
111000011000000000001110000000000000000000111
111000011000000000001110000000000000000000111
111000011000000000001110000000000000000000111
111000011000000000001110000000000000000000111
111000000000000000001110000000011110000000111
111000000000001100001110000000111110000000111
111000000000001100001111000001111110000000111
111000000000000000001111100111110000000000111
111000000000000000001111111111100000000000111
111000000000011110001111111111111100000000111
111000000000011110001111111111111100000000111
111000000000000000001111111111111100000000111
111000000000000000000001100000011100000000111
111000000000000000000001100000000000000000111
111000111000000000000001100000000000000000111
111000111000000000000000000000000000000000111
111000111000000000011000000000000000000000111
111000000000000000011000000110011100000000111
111000000000000000011000000110011100000000111
111000000000000000000000000110011100000000111
111000000000000000000000000000011100000000111
111111111111111111111111111111111111111111111
111111111111111111111111111111111111111111111
111111111111111111111111111111111111111111111