111111111111111111111111111111111111111111111
111111111111111111111111111111111111111111111
111111111111111111111111111111111111111111111
111000010000000000001111111111002222200000000
111000010000000000001111111100002222000000000
111000000000000000001111111000000222000000000
111222200000000000001111100000000022000000000
111222211100000000001111220000000022200000000
111222211100000000001111220000000022200000000
111222211100000000001111222000000002110000111
111222222200000000001111222000001111111100111
111222222200000000001110222220001111111111111
111222222200000000001110020222220011111111111
111222222200000000001110000222222001111111111
111000000000000000001110000222222000011111111
111111110000101111111110002222200000011111111
111111110000001111111110002222000000001111111
111111110000001111111110002222000000000111111
111200000000000000001110222112222000000011111
111000000000000000001112222211112220000000111
111000000222000000001112022211112220000000111
111220002222220110001110000221222200000000111
111220002222220110001110000222222000000000111
111022000222222000001110002200000000000000111
111022211222222000001110000000000000022222111
111000011222220000001110000000000000022220111
111000011222220000001110000000000002222200111
111000011222200002201110220000000022220000111
111000000000000022221112222200011112220000111
111002200000001122221112222222111112000000111
111002222220021120001111222221111110000000111
111000022222222000001111122111110000000000111
111000022222200000001111111111100000000000111
111000000222211110001111111111111100000000111
111000000222211110001111111111111100000022111
111000000022200000001111111111111122000222111
111000000022220000000001100000011122222222111
111000000022222200000001100000000002222222111
111000111222222200000001100000000000000222111
111000111222222200000000000000000000000022111
111000111222222000011000000000000000000022111
111000000022220000011000000110011100000002111
111000000000200000011000000110011100000002111
111000000000000000000000000110011100000002111
111000000000000000000000000000011100000000111
111111111111111111111111111111111111111111111
111111111111111111111111111111111111111111111
111111111111111111111111111111111111111111111