111111111111
101101001001
100000000001
100000000011
110000000001
110000001101
111111011111